12
1,5,5,5,5,5,5,5,5,5,5,6
1,7,5,7,5,5,5,5,5,7,5,12
1,12,3,13,7,5,7,4,1,13,5,4
1,7,13,5,13,5,13,4,1,7,5,6
3,13,5,5,5,5,5,5,5,13,5,12
9,5,7,5,6,3,7,7,5,7,5,6
1,5,13,5,14,9,12,8,3,12,1,12
1,5,5,5,13,7,5,5,15,5,5,4
1,5,5,5,5,13,5,5,12,3,6,2
1,5,5,5,5,5,7,5,7,12,9,12
1,5,5,7,5,7,13,7,13,7,4,2
1,5,5,12,1,13,4,9,4,9,5,12
